call centre agents – gi group – milton keynes #url# #url#
hr information specialist (german) – headhunt international – galway #url#
care assistant – bank – barchester healthcare – flint ch6 #url# #url#
environmental services tech – self regional healthcare – greenwood, sc #url#
billing representative – unitedhealth group – northridge, ca #url#
mathematics teacher – trinity charter schools – canyon lake, tx #url#
math specialist – convent of the sacred heart – new york, ny #url#
nanny needed for 1 child in pilgrim – #url# – pilgrim, ky #url#
project manager – south west personnel – bunbury wa #url#
programmatic trader – xpand group – sydney nsw #url#
paraplanner – southern sydney (bexley) – ensure recruitment – sydney nsw #url# #url#
graphic designer – x billion labs – mumbai, maharashtra #url#
accounts manager – y- axis overseas – hyderabad, telangana #url#
escape room game guide / front desk receptionist – big escape rooms – silver spring, md #url#
business systems analyst – permanent – vantage resources – dublin #url#
technician – bell honda – phoenix, az #url#
technical support specialist – lenovo – sydney nsw #url#
special projects coordinator – city year – columbia, sc #url#
test technician – element materials technology – flintshire #url# #url#
branch assistant (24hrs) – booker wholesale – cheltenham #url# #url#
360 excavator driver – now careers – york #url# #url#
catering assistant – social bite – livingston north #url#
training services summer intern 2018 – success academy charter schools – new york, ny #url#
stack emissions testing technician – element materials technology – dublin #url# #url#
security officer – licenced – wa – indigenous identified – ngare employment solutions – perth wa #url#
food &amp; beverage manager – connacht 5* hotel – top staff recruitment – galway #url#
customer service assistant – gala bingo – wakefield #url#
plant and procurement co-ordinator – kn group – dublin #url#
housing coordinator – broome – foundation housing ltd – broome wa #url#
breakfast attendant – hotel lafayette – buffalo, ny #url#
healthcare customer service team lead – tcp group – dublin #url#
receptionist/facilities administrator – shrine services – canada, ky #url#
kitchen assistant – orchard care group – wrexham #url#
customer care executive (cce) – krsv solutions – chennai, tamil nadu #url#
direct support professional – lutheran social service of minnesota – little falls, mn #url#
2 x ab perm ahts – worldwide recruitment solutions – newcastle nsw #url#
network system administrator – fortunearrt led lighting pvt ltd – hyderabad, telangana #url#
verification specialist – entrust datacard – canada, ky #url#
deputy principal legal officer – elias recruitment – brisbane qld #url# #url#
cook/chef – sodexo uk and ireland – sunderland #url#
marketing &amp; business development executive – leinster environmentals – dundalk, county louth #url#
post primary maths teacher – career teachers – dublin #url#
scrum master / people leader – fintech – oscar thomas group – melbourne vic #url#
retail customer advisor – three – corby #url#
registered nurse-6 north medical/surgical day weekender – st. dominic hospital – jackson, ms #url#
driver cdl – country club services inc – long island, ny #url#
wanted accounts executive – euroschool whitefield – whitefield, bengaluru, karnataka #url#
manager – risk analytics – deloitte – melbourne vic #url#
chaplain – northaven community – baptcare – australia #url#
student placement – community health placement – maroondah city council – victoria #url#
ambulatory clinic supervisor i (neurology) – boston children’s hospital – boston, ma #url#
executive assistant – marriott international, inc – hyderabad, telangana #url#
clinical research coordinator (research assistant 2) – oregon health &amp; science university – portland, or… #url#
waterford, retail sales agent 34k ote – british sky broadcasting group – waterford #url# #url#
abseiler rope access operative irata – noonan – dublin #url#
warehouse administrator – staffline – macroom, county cork #url#
flying start health visitor – aneurin bevan university health board – tredegar np22 #url#
assistant general manager/ deputy general manager- recovery (harihar) – aditya birla group – haveri, karnataka #url#
national sales director – michael page – brisbane qld #url#
veterinary technician/assistant – well pets economy clinics – indianapolis, in #url#
support worker – sugarman health &amp; wellbeing – flintshire #url#
sales executive, dublin – harpercollins – dublin #url#
process leader – red rock partnership ltd – evesham #url#
international claims executive – william russell – united kingdom #url#
babysitter wanted in monkstown – babysitting monkstown – babysits – monkstown, county dublin #url#
consultant || uttarakhand – mount talent consulting – roorkee, uttarakhand #url#
3rd shift grocery stocking team leader – meijer – camby, in #url# #url#
lg company have requirement fresher apply – – titau cair indus. – sarita vihar, delhi, delhi #url#
general laborer – fasttrack staffing, inc – summerfield, fl #url# #url#
nuclear medicine technologist – invicro – new haven, ct #url#
warehouse operative – castleview group training limited – spalding #url#
labourer with driving licence – architectural glazing solutions – portsmouth po6 #url#
urgent requirement for back office executive at swiggy – mak management – kolkata, west bengal #url#
lead microbiology analyst – collins mcnicholas – cork #url#
customer service administrator – sligo – abtran – sligo #url#
field locator – headway workforce solutions – norfolk, va #url#
mechanical supervisor / foreman – granite services international – delhi, delhi #url#
pathway programme teaching opportunities – educo – dublin #url#
allied health assistant (paediatric) – dpv health – melbourne vic #url#
cleaner (full-time) – livingcity asset management ltd – manchester central #url#
cleaning operative – momentum support – galway #url#
document collection verification executives fresher apply – euphoria infotech – sonia vihar, delhi, delhi #url#
lab technician – histopathology – apollo hospitals – chennai, tamil nadu #url#
airlines vacancy for 10th &amp; 12th pass candidates – daniel professional private ltd. – kolkata, west bengal #url#
spa therapist – spa and salon staff recruitment – stafford #url#
technical sales executive – adecco – cork #url#
territory business executive – novartis pharma – indore, madhya pradesh #url#
officer- ehs – trs staffing solutions – india #url#
financial adviser – kaizen recruitment – melbourne vic #url#
data analyst-immediate joining – aastha agri link – nagloi, delhi #url#
chef – baxterstorey ltd – fleet #url#
store team member (cashier/stocker/animal care) – pet supplies plus – odenton, md #url# #url#
driver/installer – cdl license required – rain for rent – gillette, wy #url#
supervisor mobile maintenance – bhp – western australia #url#
diesel technician – campbell &amp; partners – queensland #url#
back office / data entry typist/computor typist punit das – invoice tech – hari nagar, delhi, delhi #url#
wanted: qualified experience childcare near straffan [every saturday ] – kildare #url#
franchise manager – realworld solutions – ahmedabad, gujarat #url#
handyman/painter – st judes disability services – perth wa #url#
sales / online marketing / admin – ripples bathrooms – dublin #url#
