ondatrÃ³pica - ondatrÃ³pica &lt;br&gt;  #url#  for the baby
doris day - my heart &lt;br&gt;  #url#  deal of the day
various artists - the rough guide to undiscovered world &lt;br&gt;  #url#  deal of the day
heatwave - central heating &lt;br&gt;  #url#  deal of the day
nino rota - nino rota collector &lt;br&gt;  #url#  kindle
trent reznor - the girl with the dragon tattoo &lt;br&gt;  #url#  get your own audio stream
luther vandross - busy body &lt;br&gt;  #url#  deal of the day
conquering animal sound - on floating bodies &lt;br&gt;  #url#  for the baby
plastician - dubstep allstars vol. 10: plastician &lt;br&gt;  #url#  deal of the day
henry mancini - breakfast at tiffany's - 50th anniversary edition &lt;br&gt;  #url#  stills
bruno mars - unorthodox jukebox &lt;br&gt;  k  k
is she marching off because of briexit i wonder if shes  say or leave rofl ?bbc news - 'awesome' warrior queen boudâ€¦ #url#
fela kuti - the best of the black president 2 &lt;br&gt;  k  k
clinton fearon - heart and soul  &lt;br&gt;  #url#  for the baby
typical bbc news - bank of england: city watchdog looks into pound's jump #url#
delphic - collections &lt;br&gt;  #url#  get your own audio stream
various artists - diablos del ritmo â€“ the colombian melting pot 1960-1985 &lt;br&gt;  #url#  get your own audio stream
post office 'assisting' review of postmasters' convictions&lt;br&gt;  #url#  kindle
damon albarn - dr dee &lt;br&gt;  #url#  deal of the day
jeff wayne - jeff wayne's musical version of the war of the worlds â€“ the new generation &lt;br&gt;  #url#  for the baby
wiley - the ascent &lt;br&gt;  #url#  for the baby
broadcast - berberian sound studio &lt;br&gt;  #url#  deal of the day
mogwai - les revenants &lt;br&gt;  #url#  hic
peaking lights - lucifer in dub &lt;br&gt;  #url#  stills
josh groban - all that echoes &lt;br&gt;  #url#  stills
spinal tap - this is spinal tap &lt;br&gt;  #url#  for the baby
time to stop buying from china what's really happening in  ðŸ‡¨ðŸ‡³  china?.   it is shocking how little we see what happâ€¦ #url#
lesley garrett - a north country lass &lt;br&gt;  #url#  hic
various artists - beginnerâ€™s guide to flamenco &lt;br&gt;  #url#  for the baby
ben montague - tales of flying and falling &lt;br&gt;  #url#  hic
etana - better tomorrow &lt;br&gt;  #url#  hic
the knife - shaking the habitual &lt;br&gt;  #url#  get your own audio stream
pusha t - wrath of caine &lt;br&gt;  #url#  stills
various artists - james brownâ€™s funky people, part 1 &lt;br&gt;  #url#  kindle
kilo kish - k  &lt;br&gt;  #url#  get your own audio stream
example - the evolution of man &lt;br&gt;  #url#  deal of the day
dido - girl who got away &lt;br&gt;  #url#  deal of the day
one direction - take me home  &lt;br&gt;  #url#  kindle
beres hammond - one love, one life &lt;br&gt;  #url#  get your own audio stream
incognito - positivity &lt;br&gt;  #url#  for the baby
barrington levy - reggae anthology: sweet reggae music (1979-84) &lt;br&gt;  #url#  kindle
olly murs - right place right time &lt;br&gt;  #url#  for the baby
salif keita - talÃ© &lt;br&gt;  #url#  get your own audio stream
young fathers - tape one &lt;br&gt;  #url#  for the baby
autechre - exai &lt;br&gt;  #url#  deal of the day
big boi - vicious lies and dangerous rumours &lt;br&gt;  #url#  hic
laura mvula - sing to the moon &lt;br&gt;  #url#  get your own audio stream
seth macfarlane - music is better than words &lt;br&gt;  #url#  hic
perhaps we can work a exchange anne sacoolas, an american citizen and wife of a u.s. diplomat, who is accused of caâ€¦ #url#
pantha du prince - elements of light &lt;br&gt;  #url#  hic
rose royce - car wash &lt;br&gt;  #url#  stills
antibalas - antibalas &lt;br&gt;  #url#  get your own audio stream
yasmin levy - libertad &lt;br&gt;  #url#  deal of the day
blue hawaii - untogether &lt;br&gt;  #url#  stills
justin timberlake - the 20/20 experience &lt;br&gt;  #url#  hic
devlin - a moving picture &lt;br&gt;  #url#  for the baby
davos 2020: what to expect at the wef summit&lt;br&gt;  #url#  deal of the day
matthew herbert - herbert complete  &lt;br&gt;  #url#  get your own audio stream
matmos - the marriage of true minds &lt;br&gt;  #url#  kindle
alicia keys - girl on fire &lt;br&gt;  #url#  get your own audio stream
amy winehouse - amy winehouse at the bbc &lt;br&gt;  #url#  get your own audio stream
dj day - land of 1000 chances &lt;br&gt;  #url#  hic
no worries with him being up at the crack of dawn then bbc news - phillip schofield: itv presenter comes out as gay #url#
vondelpark - seabed &lt;br&gt;  #url#  deal of the day
how the dog biscuit became a million dollar idea&lt;br&gt;  #url#  hic
various artists - christmas rules &lt;br&gt;  #url#  deal of the day
the creole choir of cuba - santiman &lt;br&gt;  #url#  kindle
mic righteous - open mic &lt;br&gt;  #url#  deal of the day
aretha franklin - lady soul &lt;br&gt;  #url#  get your own audio stream
the underachievers - indigoism &lt;br&gt;  #url#  hic
cliff martinez - drive: original motion picture soundtrack &lt;br&gt;  #url#  for the baby
space dimension controller - welcome to mikrosector-50 &lt;br&gt;  k  k
surly all of them do it does not show the instant your infected with any !bbc news - china coronavirus: 2,000 infecâ€¦ #url#
rihanna - unapologetic &lt;br&gt;  #url#  hic
a$ap rocky - #url#$ap &lt;br&gt;  #url#  get your own audio stream
youssou nâ€™dour - from senegal to the world: 80s classics and rarities &lt;br&gt;  k  k
health - max payne 3: the official soundtrack &lt;br&gt;  #url#  get your own audio stream
sexy fi - nunca te vi de boa  &lt;br&gt;  #url#  for the baby
atoms for peace - amok &lt;br&gt;  #url#  for the baby
bobby brown - donâ€™t be cruel &lt;br&gt;  #url#  for the baby
this is what a million pound coin looks like&lt;br&gt;  #url#  for the baby
bonobo - the north borders &lt;br&gt;  #url#  kindle
various artists - 30 - real world at womad &lt;br&gt;  k  k
various artists - the trevor nelson collection &lt;br&gt;  #url#  deal of the day
john carpenter - halloween ii / halloween iii: season of the witch &lt;br&gt;  #url#  kindle
faltydl - hardcourage  &lt;br&gt;  #url#  for the baby
boards of canada - music has the right to children &lt;br&gt;  #url#  stills
vangelis - the collection &lt;br&gt;  k  k
hays travel: 'we're different to thomas cook'&lt;br&gt;  #url#  stills
emilia mitiku - i belong to you &lt;br&gt;  #url#  for the baby
hi-tension - hi-tension &lt;br&gt;  #url#  deal of the day
the supremes - where did our love go &lt;br&gt;  #url#  get your own audio stream
various artists - reggae golden jubilee: origins of jamaican music â€“ 50th anniversary  &lt;br&gt;  k  k
ceo secrets: vegan ice cream entrepreneur shares her advice&lt;br&gt;  k  k
the tourÃ©-raichel collective - the tel aviv session &lt;br&gt;  #url#  kindle
that divide that puts the southeast ie london and the home counties in best place  again bbc news - lives 'at risk'â€¦ #url#
ke$ha - warrior &lt;br&gt;  #url#  get your own audio stream
modestep - evolution theory  &lt;br&gt;  k  k
goat - world music &lt;br&gt;  #url#  hic
the isley brothers - harvest for the world &lt;br&gt;  #url#  hic
